####################################################################################################
#                                                                                       ############
# ############ ############################## ######################################### ############
# ############ ############################## ###########################                      #####
# ############ ############################## ########################### #################### #####
# ############ ############################## ########################### #################### #####
# ############ ############################## ########################### #################### #####
# ############                                                            #################### #####
# ############ ############### ############## ################################################ #####
# ############ ############### ############## ################################################ #####
#  ########### ############### ############## ################################################ #####
## ########### ###############                                                        ######## #####
## ########### ############################## ################# ##################### ######## #####
## ########### ############################## ################# ##################### ######## #####
## ########### ############################## ################# ##################### ######## #####
## ########### ############################## ################# ##################### ######## #####
## ########### ############################## ################# ##################### ######## #####
## ########### ############################## ################# ##################### ######## #####
##                                                      ####### ##################### ######## #####
## ########### ######################################## ####### ##################### ######## #####
## ########### ######################################## ####### ##################### ######## #####
## ########### ########################################                                        #####
## ########### ################################################ ############################## #####
## ########### ################################################ ############################## #####
## ########### ################################################ ############################## #####
## ###########                                                  ############################## #####
## ################################ ########################################################## #####
## ################################ ########################################################## #####
## ################################ ########################################################## #####
## ################################ ########################################################## #####
##                                                                                             #####
## ############### ################################ ######################## ################# #####
## ############### ################################ ######################## ################# #####
## ############### ################################ ######################## ################# #####
## ###############               ################## ######################## ################# #####
## ############### ############# ################## ###########              ################# #####
## ############### ############# ################## ########### ############ ################# #####
## ############### ############# ################## ########### ############ ################# #####
## ############### ############# ################## ########### ############ ################# #####
##                 #############                                ############                       #
########### ####################################### ####### ################ ##################### #
########### ####################################### ####### ################ ##################### #
########### ####################################### ####### ################ ##################### #
########### ####################################### #######                  ##################### #
########### ####################################### ######################## ##################### #
########### ####################################### ######################## ##################### #
###########                                                                  ##################### #
############################################################################ ##################### #
############################################################################                       #
####################################################################################################
